######################
#                  A #
#   S                #
#             M      #
#                    #
#                    #
#                    #
#                    #
#                S   #
#                    #
######################
