######################
#                    #
#   S                #
#                    #
#                    #
#                    #
#                    #
#                    #
#                    #
#                    #
######################
