%%%%%%%%%%%%%%%%%%%%%%
%  %%%     %         %
%  %S%  %  %  %      %
%  % %  %  %  %      %
%  %    %%%%  %      %
%  % %     %  %     A%
%    %%% %%%  %%%%%%%%
%  %   % %           %
% %%   % %%%%%%%%%%  %
%      %             %
%%%%%%%%%%%%%%%%%%%%%%