%%%%%%%%%%%%%%%%%%%%%%
%                    %
%   S         M      %
%                    %
%             Y      %
%                    %
%             A      %
%                    %
%             B      %
%                    %
%%%%%%%%%%%%%%%%%%%%%%