#########################
#                       #
#   S                   #
#             M         #
#                       #
#                       #
#             A         #
#                       #
#########################                   
