#########################
#              A        #
#   S                   #
#   A       AAAAAAAAA   #
#   A         A         #
#   A                   #
#   AAA       A  A  A   #
#   AA                  #
#########################                   
