######################
#                    #
#   S                #
#                    #
#           A        #
#                    #
#            A       #
#                    #
#            AAA     #
#                    #
######################
